10
20
#EEEEEEEEEEDDDDDDDD#
#*III@**********KKT#
#*EEEIDDD*EEE**DKKK#
#*E1EID1D*E1E*DDIKK#
#*E1EID1D*EEE**DIII#
#*EEEIDDD*E***DDDII#
#******************#
#******************#
#*****************%#
#DDDDDDDDDEEEEEEEEE#