10
15
@**************
*EEE*DDD*EEE***
*E1E*D1D*E1E***
*E1E*D1D*EEE***
*EEE*DDD*E*****
***************
******D********
*****DD********
******D********
*****DDD******T